30 30
0 100
0 1 2
0 0 0 0 0 0 0 0 0 0 0 0 0 0 0 0 0 0 0 0 0 0 0 0 0 0 0 0 0 13
0 0 0 0 0 0 0 0 0 0 0 0 0 0 0 0 0 0 1 3 0 2 0 2 0 2 0 2 0 13
0 0 0 0 0 2 3 0 0 0 0 0 0 0 0 0 0 0 5 7 0 0 0 0 0 0 0 0 0 2
0 0 0 20 0 5 7 0 0 0 1 0 0 0 0 0 0 0 1 2 0 0 0 0 0 0 0 0 0 2
2 0 0 2 2 2 2 2 2 2 2 2 2 2 2 2 2 2 2 2 0 0 2 2 2 2 2 2 2 2
60 62 0 2 0 0 0 0 0 0 0 0 0 0 0 0 0 0 0 2 0 0 0 0 0 0 0 0 1 2
61 63 0 2 30 0 0 32 0 0 4 6 0 0 0 0 0 0 0 2 0 30 0 0 0 0 0 0 1 2
2 1 3 2 20 20 20 20 20 20 20 20 20 20 20 20 20 20 0 2 0 31 0 0 0 0 0 0 1 2
2 5 7 1 3 0 31 0 0 0 0 0 0 0 0 0 0 20 0 2 2 2 0 30 0 0 0 0 1 2
2 0 0 5 7 0 0 31 0 0 0 0 0 0 0 0 0 20 0 1 3 0 0 0 0 0 0 0 1 2
2 20 20 20 20 20 20 20 20 20 20 20 0 0 0 0 0 20 0 5 7 0 0 0 0 0 0 0 1 2
2 0 0 0 0 0 0 0 0 1 3 20 0 0 0 0 0 20 0 2 0 0 0 0 0 0 0 0 1 2
2 0 0 0 0 0 0 0 0 5 7 20 0 0 0 0 0 20 0 2 0 0 0 0 0 0 0 0 1 2
2 0 0 0 0 0 0 0 0 0 0 20 0 0 0 0 0 20 0 2 0 0 0 0 0 0 0 0 1 2
2 0 0 0 0 0 0 0 0 0 0 20 0 0 20 20 20 20 0 2 0 0 0 0 0 0 0 0 1 2
2 0 0 0 0 0 0 0 0 0 0 20 0 0 0 0 0 0 0 2 0 0 0 0 0 0 0 0 1 2
2 0 0 0 0 0 1 3 0 0 0 20 20 20 20 20 20 20 20 2 0 0 0 0 0 0 0 0 1 2
2 0 0 0 0 0 5 7 0 0 0 0 0 0 0 0 0 0 0 2 0 0 0 0 0 0 0 0 1 2
2 0 0 0 0 0 0 0 0 0 0 0 2 0 0 0 0 0 0 2 0 0 0 0 0 0 0 0 1 2
2 0 0 0 0 0 0 0 0 0 0 0 0 0 0 0 0 0 0 2 0 0 0 0 0 0 0 0 1 2
2 0 0 0 0 0 0 0 0 0 0 0 0 0 0 0 0 0 0 2 0 0 0 0 0 0 0 0 1 2
2 0 0 0 0 0 0 0 0 0 0 0 0 0 0 0 0 0 0 2 0 0 0 0 0 0 0 0 1 2
2 0 0 0 0 0 0 0 0 0 0 0 0 0 0 0 0 0 0 2 0 0 0 0 0 0 0 0 1 2
2 0 0 0 0 0 0 0 0 0 0 0 0 0 0 0 0 0 1 2 0 0 0 0 0 0 0 0 1 2
2 0 0 0 0 0 0 0 0 0 0 0 0 0 0 0 0 0 5 2 0 0 0 0 0 0 0 0 1 2
2 0 0 0 0 0 0 0 0 0 0 0 0 0 0 0 0 0 0 2 0 0 0 0 0 0 0 0 1 2
2 0 0 0 0 0 0 0 0 0 0 0 0 0 0 0 0 0 0 2 0 0 0 0 0 0 0 0 1 2
2 0 0 0 0 0 0 0 0 0 0 0 0 0 0 0 0 0 0 2 0 0 0 0 0 0 0 0 1 2
0 0 0 0 0 0 0 0 0 0 0 0 0 0 0 0 0 0 0 2 0 0 0 0 0 0 0 0 0 0
0 0 2 2 2 2 2 2 2 2 2 2 2 2 2 2 2 2 2 2 2 2 2 2 2 2 2 0 0 0